Amazing quality and great value.	POS
Amazing quality and great value. - no regrets!	POS
Amazing quality and great value. and I told all my friends!	POS
Amazing quality and great value. and Iâ€™ll buy it again!	POS
Amazing quality and great value. can't believe how great it is.	POS
Amazing quality and great value. for sure!	POS
Amazing quality and great value. it's that good.	POS
Amazing quality and great value. just wow!	POS
Amazing quality and great value. would give 10 stars if I could!	POS
Amazing quality and great value. ðŸ’¯	POS
Definitely a five-star experience. - no regrets!	POS
Definitely a five-star experience. and I told all my friends!	POS
Definitely a five-star experience. and Iâ€™ll buy it again!	POS
Definitely a five-star experience. can't believe how great it is.	POS
Definitely a five-star experience. for sure!	POS
Definitely a five-star experience. it's that good.	POS
Definitely a five-star experience. just wow!	POS
Definitely a five-star experience. would give 10 stars if I could!	POS
Definitely a five-star experience. ðŸ’¯	POS
Excellent performance overall.	POS
Excellent performance overall. - no regrets!	POS
Excellent performance overall. and I told all my friends!	POS
Excellent performance overall. and Iâ€™ll buy it again!	POS
Excellent performance overall. can't believe how great it is.	POS
Excellent performance overall. for sure!	POS
Excellent performance overall. it's that good.	POS
Excellent performance overall. would give 10 stars if I could!	POS
Excellent performance overall. ðŸ’¯	POS
Extremely satisfied with the outcome.	POS
Extremely satisfied with the outcome. - no regrets!	POS
Extremely satisfied with the outcome. and I told all my friends!	POS
Extremely satisfied with the outcome. and Iâ€™ll buy it again!	POS
Extremely satisfied with the outcome. can't believe how great it is.	POS
Extremely satisfied with the outcome. for sure!	POS
Extremely satisfied with the outcome. it's that good.	POS
Extremely satisfied with the outcome. just wow!	POS
Extremely satisfied with the outcome. would give 10 stars if I could!	POS
Extremely satisfied with the outcome. ðŸ’¯	POS
Highly recommend this to everyone. - no regrets!	POS
Highly recommend this to everyone. and I told all my friends!	POS
Highly recommend this to everyone. and Iâ€™ll buy it again!	POS
Highly recommend this to everyone. can't believe how great it is.	POS
Highly recommend this to everyone. for sure!	POS
Highly recommend this to everyone. it's that good.	POS
Highly recommend this to everyone. just wow!	POS
Highly recommend this to everyone. would give 10 stars if I could!	POS
Highly recommend this to everyone. ðŸ’¯	POS
I completely loved this product.	POS
I completely loved this product. and I told all my friends!	POS
I completely loved this product. and Iâ€™ll buy it again!	POS
I completely loved this product. it's that good.	POS
I completely loved this product. just wow!	POS
I completely loved this product. would give 10 stars if I could!	POS
I completely loved this product. ðŸ’¯	POS
I couldn't be happier with the results.	POS
I couldn't be happier with the results. - no regrets!	POS
I couldn't be happier with the results. and I told all my friends!	POS
I couldn't be happier with the results. and Iâ€™ll buy it again!	POS
I couldn't be happier with the results. can't believe how great it is.	POS
I couldn't be happier with the results. for sure!	POS
I couldn't be happier with the results. it's that good.	POS
I couldn't be happier with the results. just wow!	POS
I couldn't be happier with the results. would give 10 stars if I could!	POS
I couldn't be happier with the results. ðŸ’¯	POS
I love how well it works.	POS
I love how well it works. - no regrets!	POS
I love how well it works. and I told all my friends!	POS
I love how well it works. and Iâ€™ll buy it again!	POS
I love how well it works. can't believe how great it is.	POS
I love how well it works. for sure!	POS
I love how well it works. it's that good.	POS
I love how well it works. just wow!	POS
I love how well it works. would give 10 stars if I could!	POS
I love how well it works. ðŸ’¯	POS
I really loved this product.	POS
I really loved this product. can't believe how great it is.	POS
I really loved this product. just wow!	POS
I really loved this product. would give 10 stars if I could!	POS
I totally loved this product.	POS
I totally loved this product. and I told all my friends!	POS
I totally loved this product. and Iâ€™ll buy it again!	POS
I totally loved this product. for sure!	POS
I totally loved this product. it's that good.	POS
I totally loved this product. would give 10 stars if I could!	POS
I totally loved this product. ðŸ’¯	POS
I truly loved this product.	POS
I truly loved this product. - no regrets!	POS
I truly loved this product. and I told all my friends!	POS
I truly loved this product. and Iâ€™ll buy it again!	POS
I truly loved this product. for sure!	POS
I truly loved this product. would give 10 stars if I could!	POS
I truly loved this product. ðŸ’¯	POS
I'm so happy with my purchase.	POS
I'm so happy with my purchase. - no regrets!	POS
I'm so happy with my purchase. and Iâ€™ll buy it again!	POS
I'm so happy with my purchase. can't believe how great it is.	POS
I'm so happy with my purchase. for sure!	POS
I'm so happy with my purchase. it's that good.	POS
I'm so happy with my purchase. just wow!	POS
I'm so happy with my purchase. would give 10 stars if I could!	POS
I'm so happy with my purchase. ðŸ’¯	POS
It exceeded all my expectations.	POS
It exceeded all my expectations. - no regrets!	POS
It exceeded all my expectations. and I told all my friends!	POS
It exceeded all my expectations. and Iâ€™ll buy it again!	POS
It exceeded all my expectations. can't believe how great it is.	POS
It exceeded all my expectations. for sure!	POS
It exceeded all my expectations. it's that good.	POS
It exceeded all my expectations. just wow!	POS
It exceeded all my expectations. would give 10 stars if I could!	POS
It exceeded all my expectations. ðŸ’¯	POS
It made my day.	POS
It made my day. - no regrets!	POS
It made my day. and I told all my friends!	POS
It made my day. and Iâ€™ll buy it again!	POS
It made my day. can't believe how great it is.	POS
It made my day. it's that good.	POS
It made my day. just wow!	POS
It made my day. would give 10 stars if I could!	POS
It made my day. ðŸ’¯	POS
It's simply flawless. and Iâ€™ll buy it again!	POS
It's simply flawless. it's that good.	POS
It's simply flawless. just wow!	POS
It's simply flawless. would give 10 stars if I could!	POS
It's simply ideal.	POS
It's simply ideal. - no regrets!	POS
It's simply ideal. and I told all my friends!	POS
It's simply ideal. can't believe how great it is.	POS
It's simply ideal. for sure!	POS
It's simply ideal. it's that good.	POS
It's simply ideal. just wow!	POS
It's simply ideal. would give 10 stars if I could!	POS
It's simply ideal. ðŸ’¯	POS
It's simply spot-on.	POS
It's simply spot-on. - no regrets!	POS
It's simply spot-on. and Iâ€™ll buy it again!	POS
It's simply spot-on. can't believe how great it is.	POS
It's simply spot-on. for sure!	POS
It's simply spot-on. just wow!	POS
It's simply spot-on. ðŸ’¯	POS
The service was first-class and fast. - no regrets!	POS
The service was first-class and fast. and Iâ€™ll buy it again!	POS
The service was first-class and fast. it's that good.	POS
The service was first-class and fast. would give 10 stars if I could!	POS
The service was first-class and fast. ðŸ’¯	POS
The service was outstanding and fast. - no regrets!	POS
The service was outstanding and fast. and I told all my friends!	POS
The service was outstanding and fast. and Iâ€™ll buy it again!	POS
The service was outstanding and fast. can't believe how great it is.	POS
The service was outstanding and fast. for sure!	POS
The service was outstanding and fast. just wow!	POS
The service was top-notch and fast. - no regrets!	POS
The service was top-notch and fast. and I told all my friends!	POS
The service was top-notch and fast. and Iâ€™ll buy it again!	POS
The service was top-notch and fast. can't believe how great it is.	POS
The service was top-notch and fast. for sure!	POS
The service was top-notch and fast. would give 10 stars if I could!	POS
The service was top-notch and fast. ðŸ’¯	POS
This is exactly what I needed.	POS
This is exactly what I needed. - no regrets!	POS
This is exactly what I needed. and I told all my friends!	POS
This is exactly what I needed. and Iâ€™ll buy it again!	POS
This is exactly what I needed. can't believe how great it is.	POS
This is exactly what I needed. for sure!	POS
This is exactly what I needed. it's that good.	POS
This is exactly what I needed. just wow!	POS
This is exactly what I needed. would give 10 stars if I could!	POS
This is exactly what I needed. ðŸ’¯	POS
This is the finest thing I've bought this year.	POS
This is the finest thing I've bought this year. - no regrets!	POS
This is the finest thing I've bought this year. and I told all my friends!	POS
This is the finest thing I've bought this year. and Iâ€™ll buy it again!	POS
This is the finest thing I've bought this year. can't believe how great it is.	POS
This is the finest thing I've bought this year. it's that good.	POS
This is the finest thing I've bought this year. ðŸ’¯	POS
This is the greatest thing I've bought this year.	POS
This is the greatest thing I've bought this year. and Iâ€™ll buy it again!	POS
This is the greatest thing I've bought this year. for sure!	POS
This is the greatest thing I've bought this year. it's that good.	POS
This is the greatest thing I've bought this year. just wow!	POS
This is the greatest thing I've bought this year. would give 10 stars if I could!	POS
This is the greatest thing I've bought this year. ðŸ’¯	POS
This is the top thing I've bought this year.	POS
This is the top thing I've bought this year. - no regrets!	POS
This is the top thing I've bought this year. and I told all my friends!	POS
This is the top thing I've bought this year. and Iâ€™ll buy it again!	POS
This is the top thing I've bought this year. can't believe how great it is.	POS
This is the top thing I've bought this year. for sure!	POS
This is the top thing I've bought this year. it's that good.	POS
This is the top thing I've bought this year. just wow!	POS
This is the top thing I've bought this year. would give 10 stars if I could!	POS
This place never disappoints.	POS
This place never disappoints. - no regrets!	POS
This place never disappoints. and I told all my friends!	POS
This place never disappoints. and Iâ€™ll buy it again!	POS
This place never disappoints. can't believe how great it is.	POS
This place never disappoints. for sure!	POS
This place never disappoints. it's that good.	POS
This place never disappoints. just wow!	POS
This place never disappoints. would give 10 stars if I could!	POS
This place never disappoints. ðŸ’¯	POS
Totally worth the price.	POS
Totally worth the price. - no regrets!	POS
Totally worth the price. and I told all my friends!	POS
Totally worth the price. and Iâ€™ll buy it again!	POS
Totally worth the price. can't believe how great it is.	POS
Totally worth the price. for sure!	POS
Totally worth the price. it's that good.	POS
Totally worth the price. just wow!	POS
Totally worth the price. would give 10 stars if I could!	POS
Totally worth the price. ðŸ’¯	POS
What a brilliant experience! - no regrets!	POS
What a brilliant experience! and I told all my friends!	POS
What a brilliant experience! and Iâ€™ll buy it again!	POS
What a brilliant experience! can't believe how great it is.	POS
What a brilliant experience! for sure!	POS
What a brilliant experience! just wow!	POS
What a brilliant experience! would give 10 stars if I could!	POS
What a incredible experience!	POS
What a incredible experience! and I told all my friends!	POS
What a incredible experience! and Iâ€™ll buy it again!	POS
What a incredible experience! can't believe how great it is.	POS
What a incredible experience! it's that good.	POS
What a incredible experience! just wow!	POS
What a incredible experience! ðŸ’¯	POS
What a wonderful experience! - no regrets!	POS
What a wonderful experience! and I told all my friends!	POS
What a wonderful experience! and Iâ€™ll buy it again!	POS
What a wonderful experience! it's that good.	POS
What a wonderful experience! just wow!	POS
What a wonderful experience! would give 10 stars if I could!	POS
What a wonderful experience! ðŸ’¯	POS
Will definitely come back again!	POS
Will definitely come back again! - no regrets!	POS
Will definitely come back again! and I told all my friends!	POS
Will definitely come back again! can't believe how great it is.	POS
Will definitely come back again! for sure!	POS
Will definitely come back again! it's that good.	POS
Will definitely come back again! just wow!	POS
Will definitely come back again! ðŸ’¯	POS
Works like a charm.	POS
Works like a charm. - no regrets!	POS
Works like a charm. and I told all my friends!	POS
Works like a charm. and Iâ€™ll buy it again!	POS
Works like a charm. can't believe how great it is.	POS
Works like a charm. for sure!	POS
Works like a charm. it's that good.	POS
Works like a charm. just wow!	POS
Works like a charm. would give 10 stars if I could!	POS
Works like a charm. ðŸ’¯	POS
Avoid this at all costs.	NEG
Avoid this at all costs. I can't believe I bought this.	NEG
Avoid this at all costs. I threw it away.	NEG
Avoid this at all costs. a total disaster.	NEG
Avoid this at all costs. lesson learned.	NEG
Avoid this at all costs. never again!	NEG
Avoid this at all costs. very disappointed.	NEG
Avoid this at all costs. would not recommend.	NEG
Avoid this at all costs. â€“ absolutely horrible.	NEG
Completely ineffective and overpriced. I can't believe I bought this.	NEG
Completely ineffective and overpriced. a total disaster.	NEG
Completely ineffective and overpriced. lesson learned.	NEG
Completely ineffective and overpriced. never again!	NEG
Completely ineffective and overpriced. very disappointed.	NEG
Completely ineffective and overpriced. â€“ absolutely horrible.	NEG
Completely ineffective and overpriced. ðŸ‘Ž	NEG
Completely pointless and overpriced.	NEG
Completely pointless and overpriced. I can't believe I bought this.	NEG
Completely pointless and overpriced. a total disaster.	NEG
Completely pointless and overpriced. lesson learned.	NEG
Completely pointless and overpriced. never again!	NEG
Completely pointless and overpriced. would not recommend.	NEG
Completely pointless and overpriced. â€“ absolutely horrible.	NEG
Completely worthless and overpriced.	NEG
Completely worthless and overpriced. I threw it away.	NEG
Completely worthless and overpriced. never again!	NEG
Completely worthless and overpriced. ðŸ‘Ž	NEG
Customer service was negligent. a total disaster.	NEG
Customer service was negligent. lesson learned.	NEG
Customer service was negligent. never again!	NEG
Customer service was negligent. very disappointed.	NEG
Customer service was negligent. â€“ absolutely horrible.	NEG
Customer service was unavailable. I can't believe I bought this.	NEG
Customer service was unavailable. lesson learned.	NEG
Customer service was unavailable. never again!	NEG
Customer service was unavailable. would not recommend.	NEG
Customer service was unavailable. â€“ absolutely horrible.	NEG
Customer service was unhelpful. I threw it away.	NEG
Customer service was unhelpful. a total disaster.	NEG
Customer service was unhelpful. lesson learned.	NEG
Customer service was unhelpful. never again!	NEG
Customer service was unhelpful. very disappointed.	NEG
Customer service was unhelpful. would not recommend.	NEG
Customer service was unhelpful. â€“ absolutely horrible.	NEG
Customer service was unhelpful. ðŸ‘Ž	NEG
Extremely dissatisfied with this.	NEG
Extremely dissatisfied with this. I can't believe I bought this.	NEG
Extremely dissatisfied with this. I threw it away.	NEG
Extremely dissatisfied with this. a total disaster.	NEG
Extremely dissatisfied with this. lesson learned.	NEG
Extremely dissatisfied with this. never again!	NEG
Extremely dissatisfied with this. very disappointed.	NEG
Extremely dissatisfied with this. would not recommend.	NEG
Extremely dissatisfied with this. â€“ absolutely horrible.	NEG
Extremely dissatisfied with this. ðŸ‘Ž	NEG
I absolutely hated this experience. a total disaster.	NEG
I absolutely hated this experience. very disappointed.	NEG
I absolutely hated this experience. â€“ absolutely horrible.	NEG
I absolutely hated this experience. ðŸ‘Ž	NEG
I completely hated this experience.	NEG
I completely hated this experience. I threw it away.	NEG
I completely hated this experience. a total disaster.	NEG
I completely hated this experience. lesson learned.	NEG
I completely hated this experience. never again!	NEG
I completely hated this experience. â€“ absolutely horrible.	NEG
I completely hated this experience. ðŸ‘Ž	NEG
I regret buying this.	NEG
I regret buying this. I can't believe I bought this.	NEG
I regret buying this. I threw it away.	NEG
I regret buying this. a total disaster.	NEG
I regret buying this. lesson learned.	NEG
I regret buying this. never again!	NEG
I regret buying this. very disappointed.	NEG
I regret buying this. would not recommend.	NEG
I regret buying this. â€“ absolutely horrible.	NEG
I regret buying this. ðŸ‘Ž	NEG
I truly hated this experience.	NEG
I truly hated this experience. I can't believe I bought this.	NEG
I truly hated this experience. a total disaster.	NEG
I truly hated this experience. lesson learned.	NEG
I truly hated this experience. would not recommend.	NEG
I truly hated this experience. â€“ absolutely horrible.	NEG
I want my money back.	NEG
I want my money back. I can't believe I bought this.	NEG
I want my money back. I threw it away.	NEG
I want my money back. a total disaster.	NEG
I want my money back. lesson learned.	NEG
I want my money back. never again!	NEG
I want my money back. very disappointed.	NEG
I want my money back. would not recommend.	NEG
I want my money back. â€“ absolutely horrible.	NEG
I want my money back. ðŸ‘Ž	NEG
It broke on the first use.	NEG
It broke on the first use. I can't believe I bought this.	NEG
It broke on the first use. I threw it away.	NEG
It broke on the first use. a total disaster.	NEG
It broke on the first use. lesson learned.	NEG
It broke on the first use. never again!	NEG
It broke on the first use. very disappointed.	NEG
It broke on the first use. would not recommend.	NEG
It broke on the first use. â€“ absolutely horrible.	NEG
It broke on the first use. ðŸ‘Ž	NEG
It completely failed to meet my expectations.	NEG
It completely failed to meet my expectations. I can't believe I bought this.	NEG
It completely failed to meet my expectations. I threw it away.	NEG
It completely failed to meet my expectations. a total disaster.	NEG
It completely failed to meet my expectations. lesson learned.	NEG
It completely failed to meet my expectations. never again!	NEG
It completely failed to meet my expectations. very disappointed.	NEG
It completely failed to meet my expectations. â€“ absolutely horrible.	NEG
It completely failed to meet my expectations. ðŸ‘Ž	NEG
It was a total waste of time.	NEG
It was a total waste of time. I can't believe I bought this.	NEG
It was a total waste of time. I threw it away.	NEG
It was a total waste of time. a total disaster.	NEG
It was a total waste of time. lesson learned.	NEG
It was a total waste of time. never again!	NEG
It was a total waste of time. very disappointed.	NEG
It was a total waste of time. would not recommend.	NEG
It was a total waste of time. â€“ absolutely horrible.	NEG
It was a total waste of time. ðŸ‘Ž	NEG
Not worth the money.	NEG
Not worth the money. I can't believe I bought this.	NEG
Not worth the money. I threw it away.	NEG
Not worth the money. a total disaster.	NEG
Not worth the money. lesson learned.	NEG
Not worth the money. never again!	NEG
Not worth the money. very disappointed.	NEG
Not worth the money. would not recommend.	NEG
Not worth the money. â€“ absolutely horrible.	NEG
Not worth the money. ðŸ‘Ž	NEG
One of the most awful purchases Iâ€™ve made. I threw it away.	NEG
One of the most awful purchases Iâ€™ve made. a total disaster.	NEG
One of the most awful purchases Iâ€™ve made. never again!	NEG
One of the most awful purchases Iâ€™ve made. very disappointed.	NEG
One of the most awful purchases Iâ€™ve made. ðŸ‘Ž	NEG
One of the most disappointing purchases Iâ€™ve made. I threw it away.	NEG
One of the most disappointing purchases Iâ€™ve made. lesson learned.	NEG
One of the most disappointing purchases Iâ€™ve made. never again!	NEG
One of the most disappointing purchases Iâ€™ve made. very disappointed.	NEG
One of the terrible purchases Iâ€™ve made.	NEG
One of the terrible purchases Iâ€™ve made. I threw it away.	NEG
One of the terrible purchases Iâ€™ve made. a total disaster.	NEG
One of the terrible purchases Iâ€™ve made. lesson learned.	NEG
One of the terrible purchases Iâ€™ve made. never again!	NEG
One of the terrible purchases Iâ€™ve made. very disappointed.	NEG
One of the terrible purchases Iâ€™ve made. would not recommend.	NEG
One of the terrible purchases Iâ€™ve made. â€“ absolutely horrible.	NEG
So dissatisfied with the results.	NEG
So dissatisfied with the results. I can't believe I bought this.	NEG
So dissatisfied with the results. a total disaster.	NEG
So dissatisfied with the results. very disappointed.	NEG
So dissatisfied with the results. would not recommend.	NEG
So dissatisfied with the results. ðŸ‘Ž	NEG
So let down with the results.	NEG
So let down with the results. I can't believe I bought this.	NEG
So let down with the results. lesson learned.	NEG
So let down with the results. never again!	NEG
So let down with the results. very disappointed.	NEG
So unhappy with the results.	NEG
So unhappy with the results. I can't believe I bought this.	NEG
So unhappy with the results. a total disaster.	NEG
So unhappy with the results. very disappointed.	NEG
Such a frustrating experience.	NEG
Such a frustrating experience. I can't believe I bought this.	NEG
Such a frustrating experience. I threw it away.	NEG
Such a frustrating experience. a total disaster.	NEG
Such a frustrating experience. never again!	NEG
Such a frustrating experience. very disappointed.	NEG
Such a frustrating experience. would not recommend.	NEG
Such a frustrating experience. â€“ absolutely horrible.	NEG
Such a frustrating experience. ðŸ‘Ž	NEG
Terrible service and rude staff.	NEG
Terrible service and rude staff. I can't believe I bought this.	NEG
Terrible service and rude staff. I threw it away.	NEG
Terrible service and rude staff. a total disaster.	NEG
Terrible service and rude staff. lesson learned.	NEG
Terrible service and rude staff. never again!	NEG
Terrible service and rude staff. very disappointed.	NEG
Terrible service and rude staff. would not recommend.	NEG
Terrible service and rude staff. â€“ absolutely horrible.	NEG
Terrible service and rude staff. ðŸ‘Ž	NEG
The instructions were confusing and unhelpful.	NEG
The instructions were confusing and unhelpful. I can't believe I bought this.	NEG
The instructions were confusing and unhelpful. I threw it away.	NEG
The instructions were confusing and unhelpful. a total disaster.	NEG
The instructions were confusing and unhelpful. lesson learned.	NEG
The instructions were confusing and unhelpful. never again!	NEG
The instructions were confusing and unhelpful. very disappointed.	NEG
The instructions were confusing and unhelpful. would not recommend.	NEG
The instructions were confusing and unhelpful. â€“ absolutely horrible.	NEG
The instructions were confusing and unhelpful. ðŸ‘Ž	NEG
The most awful product I have ever used.	NEG
The most awful product I have ever used. I can't believe I bought this.	NEG
The most awful product I have ever used. I threw it away.	NEG
The most awful product I have ever used. lesson learned.	NEG
The most awful product I have ever used. never again!	NEG
The most awful product I have ever used. very disappointed.	NEG
The most awful product I have ever used. â€“ absolutely horrible.	NEG
The most disappointing product I have ever used.	NEG
The most disappointing product I have ever used. I can't believe I bought this.	NEG
The most disappointing product I have ever used. I threw it away.	NEG
The most disappointing product I have ever used. a total disaster.	NEG
The most disappointing product I have ever used. lesson learned.	NEG
The most disappointing product I have ever used. very disappointed.	NEG
The most disappointing product I have ever used. would not recommend.	NEG
The terrible product I have ever used.	NEG
The terrible product I have ever used. I can't believe I bought this.	NEG
The terrible product I have ever used. I threw it away.	NEG
The terrible product I have ever used. a total disaster.	NEG
The terrible product I have ever used. lesson learned.	NEG
The terrible product I have ever used. never again!	NEG
The terrible product I have ever used. very disappointed.	NEG
The terrible product I have ever used. â€“ absolutely horrible.	NEG
This made things worse.	NEG
This made things worse. I can't believe I bought this.	NEG
This made things worse. I threw it away.	NEG
This made things worse. a total disaster.	NEG
This made things worse. lesson learned.	NEG
This made things worse. never again!	NEG
This made things worse. very disappointed.	NEG
This made things worse. â€“ absolutely horrible.	NEG
This made things worse. ðŸ‘Ž	NEG
Very inferior quality overall.	NEG
Very inferior quality overall. I can't believe I bought this.	NEG
Very inferior quality overall. I threw it away.	NEG
Very inferior quality overall. a total disaster.	NEG
Very inferior quality overall. never again!	NEG
Very inferior quality overall. ðŸ‘Ž	NEG
Very shoddy quality overall.	NEG
Very shoddy quality overall. I threw it away.	NEG
Very shoddy quality overall. a total disaster.	NEG
Very shoddy quality overall. lesson learned.	NEG
Very shoddy quality overall. very disappointed.	NEG
Very shoddy quality overall. would not recommend.	NEG
Very substandard quality overall.	NEG
Very substandard quality overall. I can't believe I bought this.	NEG
Very substandard quality overall. a total disaster.	NEG
Very substandard quality overall. lesson learned.	NEG
Very substandard quality overall. never again!	NEG
Very substandard quality overall. â€“ absolutely horrible.	NEG
Will never use this again.	NEG
Will never use this again. I threw it away.	NEG
Will never use this again. a total disaster.	NEG
Will never use this again. lesson learned.	NEG
Will never use this again. never again!	NEG
Will never use this again. very disappointed.	NEG
Will never use this again. would not recommend.	NEG
Will never use this again. â€“ absolutely horrible.	NEG
Will never use this again. ðŸ‘Ž	NEG
